_________HHH_______H_______H__H_
____LLLLL__H_______H_______H__H_
_D_X_______________________H__H_
===================________H__H_
H_H________H__H__H========_H__H_
H_H________H__H__H__H__H___H__H_
H_H________H__H__H__H__H___H__H_
H_H________H__H__H__H__H___H__H_
H_H________H__H__H__H__H___H__H_
H_H_====___H__H__H__H__H______H_
H_H___H____H__H__H__H__H______H_
H_H___H____H__H__H__H__H________
H_H___H____H__H_____H__H__======
H_H________H__H_____H__H________
H_H_======_H__H_____H__H________
H_H___H____H__H_____H___________
H_H___H_______H_________________
H_____H_______H_____________LLLL
______________H_______LLLL___==_
_________________LLL___==____==_
LLLLLLL____LLL____=____==____==_
~~~~~~~~~~~~~~~~~~~~~~~~~~~~~~~~
