___________H_______H__________H_
_______==__H_______H__________H_
___X__________________________H_
===================___________H_
H_H________H_____H========____H_
H_H________H_____H__H__H______H_
H_H________H_____H__H__H______H_
H_H________H_____H__H__H______H_
H_H________H_____H__H__H______H_
H_H_====___H_____H__H__H______H_
H_H___H____H_____H__H__H______H_
H_H___H____H_____H__H__H________
H_H___H____H________H__H__======
H_H________H________H__H________
H_H_======_H________H__H________
H_H___H____H________H___________
H_H___H_________________________
H_____H_____________________====
______________________====___==_
_________________===___==____==_
=======_____==____=____==____==_
~~~~~~~~~~~~~~~~~~~~~~~~~~~~~~~~
