___________H_______H_______H__H_
XX_____==__H_______H_______H__H_
XX_~_______________________H__H_
===================________H__H_
H_H________H__H__H========_H__H_
H_H________H__H__H__H__H___H__H_
H_H________H__H__H__H__H___H__H_
H_H________H__H__H__H__H___H__H_
H_H________H__H__H__H__H___H__H_
H_H_====___H__H__H__H__H______H_
H_H___H____H__H__H__H__H______H_
H_H___H____H__H__H__H__H________
H_H___H____H__H_____H__H__======
H_H________H__H_____H__H________
H_H_======_H__H_____H__H________
H_H___H____H__H_____H___________
H_H___H_______H_________________
H_____H_______H_____________====
______________H_______====___==_
_________________===___==____==_
=======_____==____=____==____==_
~~~~~~~~~~~~~~~~~~~~~~~~~~~~~~~~
